0x00000004,0x00000004,0x0000001B,0x0000000E,0x0000000E,0x0000000E,0x0000000E,0x0000000E,0x0000000E,0x0000000E,0x0000001C,0x0000001D,0x0000001D,0x0000001D,0x00000004,
0x00000005,0x00000005,0x0000001B,0x0000000E,0x0000000E,0x0000000E,0x0000000E,0x0000000E,0x0000000E,0x0000000E,0x0000001B,0x00000005,0x00000005,0x00000005,0x00000005,
0x00000001,0x00000001,0x0000001B,0x0000000E,0x0000000E,0x0000000E,0x0000001C,0x0000001D,0x0000001D,0x0000001D,0x0000001E,0x00000001,0x00000001,0x00000001,0x00000001,
0x00000001,0x00000001,0x0000001B,0x0000000E,0x0000000E,0x0000000E,0x0000001B,0x00000001,0x00000001,0x00000001,0x00000001,0x00000001,0x00000001,0x00000001,0x00000001,
0x00000001,0x00000001,0x0000001F,0x0000001D,0x0000001D,0x0000001D,0x0000001E,0x00000001,0x00000001,0x00000001,0x00000001,0x00000001,0x00000001,0x00000001,0x00000001,
0x00000001,0x00000001,0x00000001,0x00000001,0x00000001,0x00000001,0x00000001,0x00000001,0x00000001,0x00000001,0x00000001,0x00000001,0x00000001,0x00000001,0x00000001,
0x00000001,0x00000001,0x00000001,0x00000001,0x00000001,0x00000001,0x00000001,0x00000001,0x00000001,0x00000001,0x00000001,0x00000001,0x00000001,0x00000001,0x00000001,
0x00000002,0x00000002,0x00000002,0x00000002,0x00000002,0x00000002,0x00000002,0x00000002,0x00000002,0x00000002,0x00000002,0x00000002,0x00000002,0x00000002,0x00000002,
0x00000001,0x00000001,0x00000001,0x00000001,0x00000001,0x00000001,0x00000001,0x00000001,0x00000001,0x00000001,0x00000001,0x00000001,0x00000001,0x00000001,0x00000001,
0x00000001,0x00000001,0x0000001C,0x0000001D,0x0000001D,0x0000001D,0x00000020,0x00000001,0x00000001,0x00000001,0x0000001C,0x0000001D,0x0000001D,0x0000001D,0x0000001D,
0x00000001,0x00000001,0x0000001B,0x0000000E,0x0000000E,0x0000000E,0x0000001B,0x00000001,0x00000001,0x00000001,0x0000001B,0x0000000E,0x0000000E,0x0000000E,0x0000000E,
0x00000001,0x00000001,0x0000001F,0x0000001D,0x0000001D,0x0000001D,0x0000001E,0x00000001,0x00000001,0x00000001,0x0000001B,0x0000000E,0x0000000E,0x0000000E,0x0000000E,
0x00000001,0x00000001,0x00000001,0x00000001,0x00000001,0x00000001,0x00000001,0x00000001,0x00000001,0x00000001,0x0000001B,0x0000000E,0x0000000E,0x0000000E,0x0000000E,
0x00000001,0x00000001,0x00000001,0x00000001,0x00000001,0x00000001,0x00000001,0x00000001,0x00000001,0x00000001,0x0000001B,0x0000000E,0x0000000E,0x0000000E,0x0000000E,
0x00000001,0x00000000,0x0000001C,0x0000001D,0x0000001D,0x0000001D,0x0000001D,0x0000001D,0x0000001D,0x0000001D,0x0000001E,0x0000000E,0x0000000E,0x0000000E,0x0000000E,
0x00000003,0x00000000,0x0000001B,0x0000000E,0x0000000E,0x0000000E,0x0000000E,0x0000000E,0x0000000E,0x0000000E,0x0000000E,0x0000000E,0x0000000E,0x0000000E,0x0000000E,
