0x00000000,0x00000001,0x00000001,0x00000001,0x00000001,0x00000001,0x00000001,0x00000002,0x00000002,0x00000001,0x00000001,0x00000001,0x00000001,0x00000001,0x00000000,
0x00000000,0x00000001,0x00000001,0x00000001,0x00000001,0x00000001,0x00000001,0x00000002,0x00000002,0x00000001,0x00000001,0x00000001,0x00000001,0x00000001,0x00000000,
0x00000000,0x00000001,0x00000001,0x00000001,0x00000001,0x00000001,0x00000001,0x00000002,0x00000002,0x00000001,0x00000001,0x00000001,0x00000001,0x00000001,0x00000000,
0x00000000,0x00000001,0x00000001,0x00000001,0x00000001,0x00000001,0x00000001,0x00000002,0x00000002,0x00000001,0x00000001,0x00000001,0x00000001,0x00000001,0x00000000,
0x00000000,0x00000001,0x00000014,0x00000001,0x00000001,0x00000001,0x00000001,0x00000002,0x00000002,0x00000001,0x00000001,0x00000001,0x00000014,0x00000001,0x00000000,
0x00000000,0x00000003,0x00000015,0x00000001,0x00000001,0x00000001,0x00000001,0x00000002,0x00000002,0x00000001,0x00000001,0x00000001,0x00000015,0x00000003,0x00000000,
0x00000016,0x00000016,0x0000000F,0x00000010,0x00000010,0x00000010,0x00000010,0x00000010,0x00000010,0x00000010,0x00000010,0x00000010,0x0000000F,0x00000016,0x00000016,
0x0000000E,0x0000000E,0x00000011,0x00000010,0x00000010,0x00000010,0x00000010,0x00000010,0x00000010,0x00000010,0x00000010,0x00000010,0x00000011,0x0000000E,0x0000000E,
0x0000000E,0x0000000E,0x00000012,0x00000010,0x00000010,0x00000010,0x00000010,0x00000010,0x00000010,0x00000010,0x00000010,0x00000010,0x00000012,0x0000000E,0x0000000E,
0x0000000E,0x0000000E,0x0000000F,0x00000010,0x00000010,0x00000010,0x00000010,0x00000010,0x00000010,0x00000010,0x00000010,0x00000010,0x0000000F,0x0000000E,0x0000000E,
0x0000000E,0x0000000E,0x00000011,0x00000010,0x00000010,0x00000010,0x00000010,0x00000010,0x00000010,0x00000010,0x00000010,0x00000010,0x00000011,0x0000000E,0x0000000E,
0x0000000E,0x0000000E,0x00000012,0x00000010,0x00000010,0x00000010,0x00000010,0x00000010,0x00000010,0x00000010,0x00000010,0x00000010,0x00000012,0x0000000E,0x0000000E,
0x0000000E,0x0000000E,0x0000000F,0x00000010,0x00000010,0x00000010,0x00000010,0x00000010,0x00000010,0x00000010,0x00000010,0x00000010,0x0000000F,0x0000000E,0x0000000E,
0x0000000E,0x0000000E,0x00000011,0x00000010,0x00000010,0x00000010,0x00000010,0x00000010,0x00000010,0x00000010,0x00000010,0x00000010,0x00000011,0x0000000E,0x0000000E,
0x0000000E,0x0000000E,0x00000012,0x00000010,0x00000010,0x00000010,0x00000010,0x00000010,0x00000010,0x00000010,0x00000010,0x00000010,0x00000012,0x0000000E,0x0000000E,
0x0000000E,0x0000000E,0x0000000F,0x00000010,0x00000010,0x00000010,0x00000010,0x00000010,0x00000010,0x00000010,0x00000010,0x00000010,0x0000000F,0x0000000E,0x0000000E,
