0x0000002D,0x0000002A,0x0000002A,0x0000002A,0x0000002A,0x0000002A,0x0000002C,0x0000002C,0x0000002A,0x0000002A,0x0000002A,0x0000002A,0x0000002A,0x0000002A,0x0000002F,
0x0000002D,0x0000002A,0x0000002A,0x0000002A,0x0000002A,0x0000002A,0x0000002C,0x0000002C,0x0000002A,0x0000002A,0x0000002A,0x0000002A,0x0000002A,0x00000030,0x00000031,
0x0000002D,0x0000002A,0x0000002A,0x0000002A,0x0000002A,0x0000002A,0x0000002C,0x0000002C,0x0000002A,0x0000002A,0x0000002A,0x00000030,0x00000031,0x00000032,0x00000033,
0x0000002D,0x0000002A,0x0000002A,0x0000002A,0x0000002A,0x0000002A,0x0000002C,0x0000002C,0x0000002A,0x00000030,0x00000031,0x00000032,0x00000033,0x00000033,0x00000034,
0x0000002D,0x0000002A,0x0000002A,0x0000002A,0x0000002A,0x0000002A,0x00000035,0x00000035,0x00000031,0x00000032,0x00000033,0x00000033,0x00000034,0x00000036,0x0000002D,
0x0000002D,0x0000002A,0x0000002A,0x0000002A,0x0000002A,0x00000030,0x00000035,0x00000035,0x00000033,0x00000033,0x00000034,0x00000036,0x0000002A,0x0000002A,0x0000002D,
0x0000002D,0x0000002A,0x0000002A,0x00000030,0x00000031,0x00000032,0x00000035,0x00000035,0x00000034,0x00000036,0x0000002A,0x0000002A,0x0000002A,0x0000002A,0x0000002D,
0x0000002D,0x00000030,0x00000031,0x00000032,0x00000033,0x00000033,0x00000035,0x00000035,0x0000002A,0x0000002A,0x0000002A,0x0000002A,0x0000002A,0x0000002A,0x0000002D,
0x00000031,0x00000032,0x00000033,0x00000033,0x00000034,0x00000036,0x00000035,0x00000035,0x0000002A,0x0000002A,0x0000002A,0x0000002A,0x0000002A,0x0000002A,0x0000002D,
0x00000033,0x00000033,0x00000034,0x00000036,0x0000002A,0x0000002A,0x0000002C,0x0000002C,0x0000002A,0x0000002A,0x0000002A,0x0000002A,0x0000002A,0x0000002A,0x0000002D,
0x00000034,0x00000036,0x0000002A,0x0000002A,0x0000002A,0x0000002A,0x0000002C,0x0000002C,0x0000002A,0x0000002A,0x0000002A,0x0000002A,0x0000002A,0x0000002A,0x0000002D,
0x0000002D,0x0000002A,0x0000002A,0x0000002A,0x0000002A,0x0000002A,0x0000002C,0x0000002C,0x0000002A,0x0000002A,0x0000002A,0x0000002A,0x0000002A,0x0000002A,0x0000002D,
0x0000002D,0x0000002A,0x0000002A,0x0000002A,0x0000002A,0x0000002A,0x0000002C,0x0000002C,0x0000002A,0x0000002A,0x0000002A,0x0000002A,0x0000002A,0x0000002A,0x0000002D,
0x0000002D,0x0000002A,0x0000002A,0x0000002A,0x0000002A,0x0000002A,0x0000002C,0x0000002C,0x0000002A,0x0000002A,0x0000002A,0x0000002A,0x0000002A,0x0000002A,0x0000002D,
0x0000002D,0x0000002A,0x0000002A,0x0000002A,0x0000002A,0x0000002A,0x0000002C,0x0000002C,0x0000002A,0x0000002A,0x0000002A,0x0000002A,0x0000002A,0x0000002A,0x0000002D,
0x0000002D,0x0000002A,0x0000002A,0x0000002A,0x0000002A,0x0000002A,0x0000002C,0x0000002C,0x0000002A,0x0000002A,0x0000002A,0x0000002A,0x0000002A,0x0000002A,0x0000002D,
