0x0000002D,0x0000002A,0x0000002A,0x0000002A,0x0000002A,0x0000002A,0x0000002C,0x0000002C,0x0000002A,0x0000002A,0x0000002A,0x0000002A,0x0000002A,0x0000002A,0x0000002D,
0x0000002D,0x0000002A,0x0000002A,0x0000002A,0x0000002A,0x0000002A,0x0000002C,0x0000002C,0x0000002A,0x0000002A,0x0000002A,0x0000002A,0x0000002A,0x0000002A,0x0000002D,
0x0000002D,0x0000002A,0x0000002A,0x0000002A,0x0000002A,0x0000002A,0x0000002C,0x0000002C,0x0000002A,0x0000002A,0x0000002A,0x0000002A,0x0000002A,0x0000002A,0x0000002D,
0x0000002D,0x0000002A,0x0000002A,0x0000002A,0x0000002A,0x0000002A,0x0000002C,0x0000002C,0x0000002A,0x0000002A,0x0000002A,0x0000002A,0x0000002A,0x0000002A,0x0000002D,
0x0000002D,0x00000000,0x00000017,0x00000018,0x00000000,0x0000002A,0x0000002C,0x0000002C,0x0000002A,0x0000002A,0x0000002A,0x0000002A,0x0000002A,0x0000002A,0x0000002D,
0x0000002D,0x00000000,0x00000019,0x0000001A,0x00000000,0x0000002A,0x0000002C,0x0000002C,0x0000002A,0x0000002A,0x0000002A,0x0000002A,0x0000002A,0x0000002A,0x0000002D,
0x0000002D,0x00000000,0x00000000,0x00000000,0x00000000,0x0000002A,0x0000002C,0x0000002C,0x0000002A,0x00000001,0x00000001,0x00000001,0x00000001,0x0000002A,0x0000002D,
0x0000002D,0x0000002A,0x0000002A,0x0000002A,0x0000002A,0x0000002A,0x0000002C,0x0000002C,0x0000002A,0x00000001,0x00000006,0x00000007,0x00000001,0x0000002A,0x0000002D,
0x0000002D,0x0000002A,0x0000002A,0x0000002A,0x0000002A,0x0000002A,0x0000002C,0x0000002C,0x0000002A,0x00000001,0x00000008,0x00000009,0x00000001,0x0000002A,0x0000002D,
0x0000002D,0x0000002A,0x0000002A,0x0000002A,0x0000002A,0x0000002A,0x0000002C,0x0000002C,0x0000002A,0x00000001,0x00000001,0x00000001,0x00000001,0x0000002A,0x0000002D,
0x0000002D,0x0000002A,0x0000002A,0x0000002A,0x0000002A,0x0000002A,0x0000002C,0x0000002C,0x0000002A,0x0000002A,0x0000002A,0x0000002A,0x0000002A,0x0000002A,0x0000002D,
0x0000002D,0x0000002A,0x0000002A,0x0000002A,0x0000002A,0x0000002A,0x0000002C,0x0000002C,0x0000002A,0x0000002A,0x0000002A,0x0000002A,0x0000002A,0x0000002A,0x0000002D,
0x0000002D,0x0000002A,0x0000002A,0x0000002A,0x0000002A,0x0000002A,0x0000002C,0x0000002C,0x0000002A,0x0000002A,0x0000002A,0x0000002A,0x0000002A,0x0000002A,0x0000002D,
0x0000002D,0x0000002A,0x0000002A,0x0000002A,0x0000002A,0x0000002A,0x0000002C,0x0000002C,0x0000002A,0x0000002A,0x0000002A,0x0000002A,0x0000002A,0x0000002A,0x0000002D,
0x0000002D,0x0000002A,0x0000002A,0x0000002A,0x0000002A,0x00000038,0x00000002,0x00000002,0x00000039,0x0000002A,0x0000002A,0x0000002A,0x0000002A,0x0000002A,0x0000002D,
0x0000002D,0x0000002A,0x0000002A,0x0000002A,0x00000038,0x00000001,0x00000002,0x00000002,0x00000001,0x00000001,0x00000039,0x0000002A,0x0000002A,0x0000002A,0x0000002D,
