0x00000000,0x00000001,0x00000001,0x00000001,0x00000001,0x00000001,0x00000001,0x00000001,0x00000001,0x00000001,0x00000001,0x00000001,0x00000001,0x00000001,0x00000000,
0x00000000,0x00000001,0x00000001,0x00000001,0x00000001,0x00000001,0x00000001,0x00000001,0x00000001,0x00000001,0x00000001,0x00000000,0x00000000,0x00000000,0x00000000,
0x00000000,0x00000001,0x00000001,0x00000001,0x00000001,0x00000001,0x00000001,0x00000000,0x00000001,0x00000001,0x00000001,0x00000000,0x00000000,0x00000000,0x00000000,
0x00000000,0x00000001,0x00000001,0x00000001,0x00000001,0x00000001,0x00000001,0x00000000,0x00000001,0x00000001,0x00000001,0x00000004,0x00000004,0x00000004,0x00000000,
0x00000000,0x00000001,0x00000001,0x00000001,0x00000001,0x00000001,0x00000001,0x00000000,0x00000001,0x00000001,0x00000001,0x00000005,0x00000005,0x00000005,0x00000000,
0x00000000,0x00000001,0x00000001,0x00000001,0x00000001,0x00000001,0x00000001,0x00000000,0x00000001,0x00000001,0x00000001,0x00000001,0x00000001,0x00000001,0x00000000,
0x00000000,0x00000001,0x00000001,0x00000001,0x00000001,0x00000001,0x00000001,0x00000004,0x00000001,0x00000001,0x00000001,0x00000001,0x00000001,0x00000001,0x00000000,
0x00000000,0x00000001,0x00000001,0x00000001,0x00000001,0x00000001,0x00000001,0x00000005,0x00000001,0x00000001,0x00000001,0x00000001,0x00000001,0x00000001,0x00000000,
0x00000000,0x00000001,0x00000001,0x00000001,0x00000001,0x00000001,0x00000001,0x00000001,0x00000001,0x00000001,0x00000001,0x00000001,0x00000001,0x00000001,0x00000000,
0x00000000,0x00000001,0x00000001,0x00000001,0x00000001,0x00000001,0x00000001,0x00000000,0x00000001,0x00000001,0x00000001,0x00000001,0x00000001,0x00000001,0x00000000,
0x00000000,0x00000001,0x00000001,0x00000001,0x00000001,0x00000001,0x00000001,0x00000000,0x00000001,0x00000001,0x00000001,0x00000001,0x00000001,0x00000001,0x00000000,
0x00000000,0x00000000,0x00000000,0x00000001,0x00000001,0x00000001,0x00000001,0x00000000,0x00000001,0x00000001,0x00000001,0x00000001,0x00000001,0x00000001,0x00000000,
0x00000000,0x00000000,0x00000000,0x00000001,0x00000001,0x00000001,0x00000001,0x00000000,0x00000001,0x00000001,0x00000001,0x00000001,0x00000001,0x00000001,0x00000000,
0x00000000,0x00000000,0x00000000,0x00000001,0x00000001,0x00000001,0x00000001,0x00000004,0x00000001,0x00000001,0x00000001,0x00000001,0x00000001,0x00000001,0x00000000,
0x00000000,0x00000004,0x00000004,0x00000001,0x00000001,0x00000001,0x00000001,0x00000005,0x00000001,0x00000001,0x00000001,0x00000001,0x00000001,0x00000001,0x00000000,
0x00000000,0x00000005,0x00000005,0x00000001,0x00000001,0x00000001,0x00000001,0x00000001,0x00000001,0x00000001,0x00000001,0x00000001,0x00000001,0x00000001,0x00000000,
