0x0000002A,0x00000047,0x00000048,0x00000048,0x00000049,0x0000002E,0x0000002E,0x0000002E,0x0000002E,0x0000002E,0x0000002E,0x0000002E,0x0000002E,0x0000002E,0x0000002E,
0x00000047,0x00000048,0x00000048,0x00000049,0x0000002A,0x0000002F,0x0000002F,0x0000002F,0x0000002F,0x0000002F,0x0000002F,0x0000002F,0x0000002F,0x0000002F,0x0000002F,
0x00000048,0x00000048,0x00000049,0x0000002A,0x0000002A,0x0000002A,0x0000002A,0x0000002A,0x0000002A,0x0000002A,0x0000002A,0x0000002A,0x0000002A,0x0000002A,0x0000002A,
0x00000048,0x00000049,0x0000002A,0x00000000,0x00000017,0x00000018,0x00000000,0x0000002A,0x0000002A,0x0000002A,0x0000002A,0x0000002A,0x0000002A,0x0000002A,0x0000002A,
0x0000004A,0x0000004A,0x0000002A,0x00000000,0x00000019,0x0000001A,0x00000000,0x0000002A,0x0000002A,0x0000002A,0x0000002A,0x0000002A,0x0000002A,0x0000002A,0x0000002A,
0x0000004A,0x0000004A,0x0000002A,0x00000000,0x00000000,0x00000000,0x00000000,0x0000002A,0x0000002A,0x0000002A,0x0000002A,0x0000002A,0x0000002A,0x0000002A,0x0000002A,
0x0000004A,0x0000004A,0x0000002A,0x0000002A,0x0000002A,0x0000002A,0x0000002A,0x0000002A,0x0000002A,0x0000002A,0x0000002A,0x0000002C,0x0000002C,0x0000002C,0x0000002C,
0x0000004A,0x0000004A,0x0000002A,0x0000002A,0x0000002A,0x0000002A,0x0000002A,0x0000002A,0x0000002A,0x0000002A,0x0000002A,0x0000002C,0x0000002A,0x0000002A,0x0000002A,
0x0000002C,0x0000002C,0x0000002C,0x0000002C,0x0000002C,0x0000002C,0x0000002C,0x0000002C,0x0000002C,0x0000002C,0x0000002C,0x0000002C,0x0000002A,0x0000002A,0x0000002A,
0x0000002A,0x0000002A,0x0000002A,0x0000002A,0x0000002A,0x0000002A,0x0000002A,0x0000002A,0x0000002A,0x0000002A,0x0000002A,0x0000002A,0x0000002A,0x0000002A,0x0000002A,
0x0000002A,0x0000002A,0x0000002A,0x0000002A,0x0000002A,0x0000002A,0x0000002A,0x0000002A,0x0000002A,0x0000002A,0x0000002A,0x0000002A,0x0000002A,0x0000002A,0x0000002A,
0x0000002A,0x0000002A,0x0000002A,0x0000002A,0x0000002A,0x0000002A,0x0000002A,0x0000002A,0x0000002A,0x0000002A,0x0000002A,0x0000002A,0x0000002A,0x0000002A,0x0000002A,
0x0000002A,0x0000002A,0x0000002A,0x0000002A,0x0000002A,0x0000002A,0x0000002A,0x0000002A,0x0000002A,0x0000002A,0x0000002A,0x0000002A,0x0000002A,0x0000002A,0x0000002A,
0x0000002A,0x0000002A,0x0000002A,0x0000002A,0x0000002A,0x0000002A,0x0000002A,0x0000002A,0x0000002A,0x0000002A,0x0000002A,0x0000002A,0x0000002A,0x0000002A,0x0000002A,
0x0000002A,0x0000002A,0x0000002A,0x0000002A,0x0000002A,0x0000002A,0x0000002A,0x0000002A,0x0000002A,0x0000002A,0x0000002A,0x0000002A,0x0000002A,0x0000002A,0x0000002A,
0x0000002E,0x0000002E,0x0000002E,0x0000002E,0x0000002E,0x0000002E,0x0000002E,0x0000002E,0x0000002E,0x0000002E,0x0000002E,0x0000002E,0x0000002E,0x0000002E,0x0000002E,
