0x0000004D,0x0000004E,0x0000004B,0x0000004B,0x0000004B,0x0000004B,0x0000004B,0x0000004B,0x0000004B,0x0000004B,0x0000004B,0x0000004B,0x0000004B,0x0000004B,0x0000004B,
0x0000004F,0x00000050,0x0000004C,0x0000004C,0x0000004C,0x0000004C,0x0000004C,0x0000004C,0x0000004C,0x0000004C,0x0000004C,0x0000004C,0x0000004C,0x0000004C,0x0000004C,
0x00000043,0x00000044,0x0000002A,0x0000002A,0x0000002A,0x0000002A,0x0000002A,0x0000002A,0x0000002A,0x0000002A,0x0000002A,0x0000002A,0x0000002A,0x0000002A,0x0000002A,
0x00000043,0x00000044,0x0000002A,0x00000000,0x00000017,0x00000018,0x00000000,0x0000002A,0x0000002A,0x0000002A,0x0000002A,0x0000002A,0x0000002A,0x0000002A,0x0000002A,
0x00000043,0x00000044,0x0000002A,0x00000000,0x00000019,0x0000001A,0x00000000,0x00000038,0x00000001,0x00000001,0x00000001,0x00000039,0x0000002A,0x0000002A,0x0000002A,
0x00000043,0x00000044,0x0000002A,0x00000000,0x00000000,0x00000000,0x00000000,0x00000001,0x00000001,0x00000001,0x00000001,0x00000001,0x00000001,0x00000039,0x0000002A,
0x00000043,0x00000044,0x0000002A,0x0000002A,0x0000002A,0x00000038,0x00000001,0x00000001,0x00000001,0x00000001,0x00000001,0x00000001,0x00000001,0x00000001,0x00000001,
0x00000043,0x00000044,0x0000002A,0x0000002A,0x00000038,0x00000001,0x00000001,0x00000029,0x0000002A,0x0000002A,0x0000002B,0x00000001,0x0000003A,0x0000003B,0x00000001,
0x00000043,0x00000044,0x0000002A,0x0000002A,0x00000001,0x00000001,0x00000001,0x0000002A,0x0000002A,0x0000002A,0x00000038,0x00000001,0x0000003C,0x0000003D,0x00000001,
0x00000043,0x00000044,0x0000002A,0x00000038,0x00000001,0x00000001,0x00000001,0x00000039,0x00000038,0x00000001,0x00000001,0x0000003A,0x0000003B,0x00000001,0x00000029,
0x00000043,0x00000044,0x0000002A,0x00000001,0x00000001,0x00000001,0x00000001,0x00000001,0x00000001,0x00000001,0x00000001,0x0000003C,0x0000003D,0x00000001,0x0000002A,
0x00000043,0x00000044,0x0000002A,0x00000001,0x0000000A,0x0000000B,0x00000001,0x00000001,0x0000000C,0x0000000D,0x0000003A,0x0000003B,0x00000001,0x00000029,0x0000002A,
0x00000043,0x00000044,0x0000002A,0x00000001,0x00000001,0x00000001,0x00000001,0x00000001,0x00000001,0x00000001,0x0000003C,0x0000003D,0x00000029,0x0000002A,0x0000002A,
0x00000043,0x00000044,0x0000002A,0x0000002B,0x00000001,0x00000001,0x00000001,0x00000001,0x00000001,0x00000001,0x00000001,0x00000029,0x00000051,0x0000002A,0x00000038,
0x00000043,0x00000044,0x0000002A,0x0000002A,0x0000002B,0x00000001,0x00000001,0x00000001,0x00000001,0x00000029,0x00000051,0x00000051,0x0000002A,0x00000038,0x00000001,
0x00000043,0x00000044,0x0000002A,0x0000002A,0x0000002A,0x00000001,0x00000001,0x00000001,0x00000029,0x00000051,0x00000051,0x00000038,0x00000001,0x00000001,0x00000004,
