0x0000004B,0x0000004B,0x0000004B,0x0000004B,0x0000004B,0x0000004B,0x0000004B,0x0000004B,0x0000004B,0x0000004B,0x0000004B,0x0000004B,0x0000004B,0x0000004B,0x0000004B,
0x0000004C,0x0000004C,0x0000004C,0x0000004C,0x0000004C,0x0000004C,0x0000004C,0x0000004C,0x0000004C,0x0000004C,0x0000004C,0x0000004C,0x0000004C,0x0000004C,0x0000004C,
0x0000002A,0x0000002A,0x0000002A,0x0000002A,0x0000002A,0x0000002A,0x0000002A,0x0000002A,0x0000002A,0x0000002A,0x0000002A,0x0000002A,0x0000002A,0x0000002A,0x00000038,
0x0000002A,0x0000002A,0x0000002A,0x00000038,0x00000006,0x00000007,0x00000001,0x00000039,0x0000002A,0x0000002A,0x0000002A,0x0000002A,0x00000038,0x00000001,0x00000001,
0x0000002A,0x0000002A,0x00000038,0x00000001,0x00000008,0x00000009,0x00000001,0x00000001,0x00000039,0x0000002A,0x00000038,0x00000001,0x00000001,0x00000001,0x00000001,
0x0000002A,0x00000038,0x00000001,0x00000001,0x00000001,0x00000001,0x00000001,0x00000001,0x00000001,0x00000001,0x00000001,0x00000001,0x00000001,0x00000001,0x00000001,
0x00000001,0x00000001,0x00000001,0x00000001,0x00000001,0x00000001,0x00000001,0x00000001,0x00000001,0x00000001,0x00000001,0x00000001,0x00000001,0x00000001,0x00000001,
0x00000001,0x00000001,0x00000029,0x0000002A,0x0000002A,0x0000002B,0x00000001,0x00000001,0x00000001,0x00000001,0x00000001,0x00000001,0x00000001,0x00000001,0x00000001,
0x00000029,0x0000002A,0x0000002A,0x0000002A,0x0000002A,0x00000038,0x00000001,0x00000001,0x00000001,0x00000001,0x00000001,0x00000001,0x00000001,0x00000001,0x00000001,
0x0000002A,0x0000002A,0x0000002A,0x00000038,0x00000001,0x00000001,0x00000001,0x00000001,0x00000001,0x00000001,0x00000001,0x00000001,0x00000001,0x00000001,0x00000001,
0x0000002A,0x00000038,0x00000001,0x00000001,0x00000001,0x00000001,0x00000001,0x00000001,0x00000001,0x00000029,0x0000002A,0x0000002A,0x0000002B,0x00000001,0x00000001,
0x0000002A,0x00000001,0x00000001,0x00000001,0x00000001,0x00000001,0x00000001,0x00000029,0x0000002A,0x0000002A,0x0000002A,0x0000002A,0x0000002A,0x0000002B,0x00000001,
0x00000038,0x00000001,0x00000001,0x00000001,0x00000001,0x00000029,0x0000002A,0x0000002A,0x0000002A,0x0000002A,0x0000002A,0x0000002A,0x0000002A,0x0000002A,0x0000002A,
0x00000001,0x00000001,0x00000029,0x0000002A,0x0000002A,0x0000002A,0x0000002A,0x0000002A,0x0000002A,0x0000002A,0x0000002A,0x0000002A,0x0000002A,0x0000002A,0x0000002A,
0x00000001,0x00000029,0x0000002A,0x0000002A,0x0000002A,0x0000002A,0x0000002A,0x0000002A,0x0000002A,0x0000002A,0x0000002A,0x0000002A,0x0000002A,0x0000002A,0x0000002A,
0x00000004,0x00000004,0x00000004,0x00000004,0x00000004,0x00000004,0x00000004,0x00000004,0x00000004,0x00000004,0x00000004,0x00000004,0x00000004,0x00000004,0x00000004,
