0x00000000,0x00000004,0x00000004,0x00000004,0x00000004,0x00000004,0x00000001,0x00000002,0x00000002,0x00000001,0x00000004,0x00000004,0x00000004,0x00000004,0x00000000,
0x00000000,0x00000005,0x00000005,0x00000005,0x00000005,0x00000005,0x00000001,0x00000002,0x00000002,0x00000001,0x00000005,0x00000005,0x00000005,0x00000005,0x00000000,
0x00000000,0x00000001,0x00000006,0x00000007,0x00000001,0x00000001,0x00000001,0x00000001,0x00000001,0x00000001,0x00000001,0x00000001,0x00000001,0x00000001,0x00000000,
0x00000000,0x00000001,0x00000008,0x00000009,0x00000001,0x00000001,0x00000001,0x00000001,0x00000001,0x00000001,0x00000001,0x00000001,0x00000001,0x00000001,0x00000000,
0x00000000,0x00000001,0x00000001,0x00000001,0x00000001,0x00000001,0x00000001,0x00000001,0x00000001,0x00000001,0x00000001,0x00000001,0x00000001,0x00000001,0x00000000,
0x0000003F,0x00000040,0x00000001,0x00000001,0x00000001,0x00000001,0x00000001,0x00000001,0x00000001,0x00000001,0x00000001,0x00000001,0x00000001,0x00000041,0x00000042,
0x00000043,0x00000044,0x0000002B,0x00000001,0x00000001,0x00000001,0x00000001,0x00000001,0x00000001,0x00000001,0x00000001,0x00000001,0x00000029,0x00000045,0x00000046,
0x00000043,0x00000044,0x0000002A,0x0000002B,0x00000001,0x00000001,0x00000001,0x00000001,0x00000001,0x00000001,0x00000029,0x0000002A,0x0000002A,0x00000045,0x00000046,
0x00000004,0x00000004,0x00000004,0x00000004,0x00000004,0x00000001,0x00000001,0x00000001,0x00000001,0x00000029,0x0000002A,0x0000002A,0x0000002A,0x00000045,0x00000046,
0x0000002A,0x0000002A,0x0000002A,0x0000002A,0x0000003F,0x00000040,0x00000001,0x00000001,0x00000001,0x00000039,0x0000002A,0x0000002A,0x0000002A,0x00000045,0x00000046,
0x0000002A,0x0000002A,0x0000002A,0x0000002A,0x00000043,0x00000044,0x00000001,0x00000001,0x00000001,0x00000001,0x00000039,0x0000002A,0x0000002A,0x00000045,0x00000046,
0x0000002A,0x0000002A,0x0000002A,0x0000002A,0x00000043,0x00000044,0x0000002B,0x00000001,0x00000001,0x00000001,0x00000001,0x0000002A,0x0000002A,0x00000045,0x00000046,
0x0000002A,0x0000002A,0x0000002A,0x0000002A,0x00000043,0x00000044,0x0000002A,0x0000002B,0x00000001,0x00000001,0x00000001,0x00000039,0x0000002A,0x00000045,0x00000046,
0x0000002A,0x0000002A,0x0000002A,0x0000002A,0x00000043,0x00000044,0x0000002A,0x0000002A,0x00000001,0x00000001,0x00000001,0x00000001,0x0000002A,0x00000045,0x00000046,
0x0000002A,0x0000002A,0x0000002A,0x0000002A,0x00000043,0x00000044,0x0000002A,0x0000002A,0x00000001,0x00000001,0x00000001,0x00000001,0x0000002A,0x00000045,0x00000046,
0x0000002A,0x0000002A,0x0000002A,0x0000002A,0x00000043,0x00000044,0x0000002A,0x0000002A,0x00000001,0x00000001,0x00000001,0x00000001,0x0000002A,0x00000045,0x00000046,
