0x00000043,0x00000044,0x0000002A,0x0000002A,0x00000001,0x00000001,0x00000001,0x00000001,0x00000001,0x00000001,0x00000001,0x0000002A,0x0000002A,0x00000045,0x00000046,
0x00000043,0x00000044,0x0000002A,0x0000002A,0x00000001,0x00000001,0x00000001,0x00000001,0x00000001,0x00000001,0x00000001,0x0000002A,0x0000002A,0x00000045,0x00000046,
0x00000043,0x00000044,0x0000002A,0x0000002A,0x00000001,0x00000001,0x00000001,0x00000001,0x00000001,0x00000001,0x00000001,0x0000002A,0x0000002A,0x00000045,0x00000046,
0x00000043,0x00000044,0x0000002A,0x0000002A,0x0000002B,0x00000001,0x00000001,0x00000001,0x00000001,0x00000001,0x00000001,0x0000002A,0x0000002A,0x00000045,0x00000046,
0x00000043,0x00000044,0x0000002A,0x0000002A,0x0000002A,0x0000002B,0x00000001,0x00000001,0x00000001,0x00000001,0x00000001,0x0000002A,0x0000002A,0x00000045,0x00000046,
0x00000043,0x00000044,0x0000002A,0x0000002A,0x0000002A,0x0000002A,0x0000002B,0x00000001,0x00000001,0x00000001,0x00000001,0x0000002A,0x0000002A,0x00000045,0x00000046,
0x00000004,0x00000004,0x00000004,0x00000004,0x00000004,0x00000004,0x00000004,0x00000001,0x00000001,0x00000001,0x00000001,0x0000002A,0x0000002A,0x00000045,0x00000046,
0x0000002A,0x0000002A,0x0000002A,0x0000002A,0x0000002A,0x0000002A,0x0000003F,0x00000040,0x00000001,0x00000001,0x00000001,0x0000002A,0x0000002A,0x00000045,0x00000046,
0x0000002A,0x0000002A,0x0000002A,0x0000002A,0x0000002A,0x0000002A,0x00000043,0x00000044,0x0000002B,0x00000001,0x00000001,0x0000002A,0x0000002A,0x00000045,0x00000046,
0x0000002A,0x0000002A,0x0000002A,0x0000002A,0x0000002A,0x0000002A,0x00000043,0x00000044,0x0000002A,0x00000001,0x00000001,0x0000002A,0x0000002A,0x00000045,0x00000046,
0x0000004D,0x0000004E,0x0000004B,0x0000004B,0x0000004B,0x0000004B,0x00000052,0x00000053,0x0000002A,0x00000001,0x00000001,0x0000002A,0x0000002A,0x00000045,0x00000046,
0x0000004F,0x00000050,0x0000004C,0x0000004C,0x0000004C,0x0000004C,0x00000054,0x00000055,0x0000002A,0x00000001,0x00000001,0x0000002A,0x0000002A,0x00000045,0x00000046,
0x00000043,0x00000044,0x0000002A,0x0000002A,0x0000002A,0x0000002A,0x0000002A,0x0000002A,0x0000002A,0x00000001,0x00000001,0x0000002A,0x0000002A,0x00000045,0x00000046,
0x00000043,0x00000044,0x00000006,0x00000007,0x00000001,0x0000002A,0x0000002A,0x0000002A,0x00000038,0x00000001,0x00000001,0x0000002A,0x0000002A,0x00000045,0x00000046,
0x00000043,0x00000044,0x00000008,0x00000009,0x00000001,0x0000002A,0x0000002A,0x00000038,0x00000001,0x00000001,0x00000001,0x0000002A,0x0000002A,0x00000045,0x00000046,
0x00000043,0x00000044,0x00000001,0x00000001,0x00000001,0x0000002A,0x00000038,0x00000001,0x00000001,0x00000001,0x00000029,0x0000002A,0x0000002A,0x00000045,0x00000046,
