0x00000043,0x00000044,0x0000002A,0x0000002A,0x0000002A,0x00000038,0x00000001,0x00000001,0x00000001,0x00000001,0x0000002A,0x0000002A,0x0000002A,0x00000045,0x00000046,
0x00000043,0x00000044,0x0000002A,0x0000002A,0x0000002A,0x00000001,0x00000001,0x00000001,0x00000001,0x00000001,0x00000039,0x0000002A,0x0000002A,0x00000045,0x00000046,
0x00000043,0x00000044,0x0000002A,0x0000002A,0x0000002A,0x00000001,0x00000001,0x00000001,0x00000001,0x00000001,0x00000004,0x00000004,0x00000004,0x00000004,0x00000004,
0x00000043,0x00000044,0x0000002A,0x0000002A,0x00000038,0x00000001,0x00000001,0x00000001,0x00000001,0x00000041,0x00000042,0x0000002A,0x0000002A,0x0000002A,0x0000002A,
0x00000043,0x00000044,0x0000002A,0x0000002A,0x00000001,0x00000001,0x00000001,0x00000001,0x00000029,0x00000045,0x00000046,0x0000002A,0x0000002A,0x0000002A,0x0000002A,
0x00000043,0x00000044,0x0000002A,0x0000002A,0x00000001,0x00000001,0x00000001,0x00000001,0x0000002A,0x00000045,0x00000046,0x0000002A,0x0000002A,0x0000002A,0x0000002A,
0x00000043,0x00000044,0x0000002A,0x0000002A,0x00000001,0x00000001,0x00000001,0x00000001,0x0000002A,0x00000045,0x00000046,0x0000002A,0x0000002A,0x0000002A,0x0000002A,
0x00000043,0x00000044,0x0000002A,0x0000002A,0x00000001,0x00000001,0x00000001,0x00000001,0x0000002A,0x00000045,0x00000046,0x0000002A,0x0000002A,0x0000002A,0x0000002A,
0x00000043,0x00000044,0x0000002A,0x0000002A,0x00000001,0x00000001,0x00000001,0x00000001,0x00000004,0x00000004,0x00000004,0x0000002A,0x0000002A,0x0000002A,0x0000002A,
0x00000043,0x00000044,0x0000002A,0x0000002A,0x00000001,0x00000001,0x00000001,0x00000041,0x00000042,0x0000002A,0x0000002A,0x0000002A,0x0000002A,0x0000002A,0x0000002A,
0x00000043,0x00000044,0x0000002A,0x0000002A,0x00000001,0x00000001,0x00000029,0x00000045,0x00000046,0x0000002A,0x0000002A,0x0000002A,0x0000002A,0x0000002A,0x0000002A,
0x00000043,0x00000044,0x0000002A,0x0000002A,0x00000001,0x00000001,0x0000002A,0x00000045,0x00000046,0x0000002A,0x0000002A,0x0000002A,0x0000002A,0x0000002A,0x0000002A,
0x00000043,0x00000044,0x0000002A,0x0000002A,0x00000001,0x00000001,0x0000002A,0x00000056,0x00000057,0x0000004B,0x0000004B,0x0000004B,0x0000004B,0x00000058,0x00000059,
0x00000043,0x00000044,0x0000002A,0x0000002A,0x00000001,0x00000001,0x00000039,0x0000005A,0x0000005B,0x0000004C,0x0000004C,0x0000004C,0x0000004C,0x0000005C,0x0000005D,
0x00000043,0x00000044,0x0000002A,0x0000002A,0x00000001,0x00000001,0x00000001,0x00000039,0x0000002A,0x0000002A,0x0000002A,0x0000002A,0x0000002A,0x00000045,0x00000046,
0x00000043,0x00000044,0x0000002A,0x0000002A,0x00000001,0x00000001,0x00000001,0x00000001,0x00000039,0x0000002A,0x0000002A,0x0000002A,0x0000002A,0x00000045,0x00000046,
