0x0000004B,0x0000004B,0x0000004B,0x0000004B,0x0000004B,0x0000004B,0x0000004B,0x0000004B,0x0000004B,0x0000004B,0x0000004B,0x0000004B,0x0000004B,0x0000004B,0x0000004B,
0x0000004C,0x0000004C,0x0000004C,0x0000004C,0x0000004C,0x0000004C,0x0000004C,0x0000004C,0x0000004C,0x0000004C,0x0000004C,0x0000004C,0x0000004C,0x0000004C,0x0000004C,
0x0000002A,0x0000002A,0x0000002A,0x0000002A,0x0000002A,0x0000002A,0x0000002A,0x0000002A,0x0000002A,0x0000002A,0x0000002A,0x0000002A,0x0000002A,0x0000002A,0x0000002A,
0x0000002A,0x0000002A,0x00000038,0x00000001,0x00000001,0x00000001,0x00000001,0x00000001,0x00000001,0x00000001,0x00000001,0x00000001,0x00000001,0x00000001,0x00000001,
0x00000038,0x00000001,0x00000001,0x00000001,0x00000001,0x00000001,0x00000001,0x00000001,0x00000001,0x00000001,0x00000001,0x00000001,0x00000001,0x00000001,0x00000001,
0x00000001,0x00000001,0x00000001,0x00000001,0x00000001,0x00000001,0x00000001,0x00000001,0x00000001,0x00000001,0x00000001,0x00000001,0x00000001,0x00000001,0x00000001,
0x00000001,0x00000001,0x00000001,0x00000001,0x00000001,0x00000001,0x00000001,0x00000001,0x00000001,0x00000001,0x00000001,0x00000029,0x0000002A,0x0000002A,0x0000002B,
0x00000001,0x00000001,0x00000001,0x00000001,0x00000001,0x00000001,0x00000001,0x00000001,0x00000001,0x00000003,0x0000005E,0x0000005E,0x0000005E,0x0000005E,0x0000005E,
0x00000001,0x00000001,0x00000001,0x00000001,0x00000001,0x00000001,0x00000001,0x00000001,0x00000041,0x00000042,0x0000002A,0x0000002A,0x0000002A,0x0000002A,0x0000002A,
0x00000001,0x00000001,0x00000001,0x00000001,0x00000001,0x00000001,0x00000029,0x0000002A,0x00000045,0x00000046,0x0000002A,0x0000002A,0x0000002A,0x0000002A,0x0000002A,
0x00000001,0x00000001,0x00000001,0x00000001,0x00000001,0x00000029,0x0000002A,0x0000002A,0x00000045,0x00000046,0x0000002A,0x0000002A,0x0000002A,0x0000002A,0x0000002A,
0x00000001,0x00000001,0x00000001,0x00000001,0x00000001,0x0000002A,0x0000002A,0x0000002A,0x00000045,0x00000046,0x0000002A,0x0000002A,0x0000002A,0x0000002A,0x0000002A,
0x00000001,0x00000001,0x00000001,0x00000001,0x00000029,0x0000002A,0x0000002A,0x0000002A,0x00000045,0x00000046,0x0000002A,0x0000002A,0x0000002A,0x0000002A,0x0000002A,
0x00000001,0x00000001,0x00000001,0x00000029,0x0000002A,0x0000002A,0x0000002A,0x0000002A,0x00000045,0x00000046,0x0000002A,0x0000002A,0x0000002A,0x0000002A,0x0000002A,
0x00000001,0x00000029,0x0000002A,0x0000002A,0x0000002A,0x0000002A,0x0000002A,0x0000002A,0x00000045,0x00000046,0x0000002A,0x0000002A,0x0000002A,0x0000002A,0x0000002A,
0x00000004,0x00000004,0x00000004,0x00000004,0x00000004,0x00000004,0x00000004,0x00000004,0x00000004,0x00000004,0x0000002A,0x0000002A,0x0000002A,0x0000002A,0x0000002A,
