0x00000043,0x00000044,0x0000002A,0x0000002A,0x00000001,0x00000001,0x00000001,0x00000001,0x00000001,0x00000001,0x00000039,0x0000002A,0x0000002A,0x00000045,0x00000046,
0x00000043,0x00000044,0x0000002A,0x0000002A,0x00000001,0x00000001,0x00000001,0x00000001,0x00000001,0x00000001,0x00000001,0x00000039,0x0000002A,0x00000045,0x00000046,
0x00000043,0x00000044,0x0000002A,0x0000002A,0x0000002B,0x00000041,0x00000042,0x0000003F,0x00000040,0x00000001,0x00000001,0x00000001,0x0000002A,0x00000045,0x00000046,
0x00000043,0x00000044,0x0000002A,0x0000002A,0x0000002A,0x00000045,0x00000046,0x00000043,0x00000044,0x0000002B,0x00000001,0x00000001,0x0000002A,0x00000045,0x00000046,
0x00000043,0x00000044,0x0000002A,0x0000002A,0x0000002A,0x00000045,0x00000046,0x00000043,0x00000044,0x0000002A,0x0000002B,0x00000001,0x0000002A,0x00000045,0x00000046,
0x00000043,0x00000044,0x0000002A,0x0000002A,0x0000002A,0x00000045,0x00000046,0x00000043,0x00000044,0x0000002A,0x0000002A,0x00000001,0x0000002A,0x00000045,0x00000046,
0x00000043,0x00000044,0x0000002A,0x0000002A,0x0000002A,0x00000045,0x00000046,0x00000043,0x00000044,0x0000002A,0x0000002A,0x00000001,0x0000002A,0x00000045,0x00000046,
0x00000043,0x00000044,0x0000002A,0x0000002A,0x0000002A,0x00000045,0x00000046,0x00000043,0x00000044,0x0000002A,0x0000002A,0x00000001,0x0000002A,0x00000045,0x00000046,
0x00000043,0x00000044,0x0000002A,0x0000002A,0x0000002A,0x00000045,0x00000046,0x00000043,0x00000044,0x0000002A,0x0000002A,0x00000001,0x0000002A,0x00000045,0x00000046,
0x00000043,0x00000044,0x0000002A,0x0000002A,0x0000002A,0x00000045,0x00000046,0x00000043,0x00000044,0x0000002A,0x0000002A,0x00000001,0x0000002A,0x00000045,0x00000046,
0x00000043,0x00000044,0x0000002A,0x0000002A,0x0000002A,0x00000045,0x00000046,0x00000043,0x00000044,0x0000002A,0x00000038,0x00000001,0x0000002A,0x00000045,0x00000046,
0x00000043,0x00000044,0x0000002A,0x0000002A,0x0000002A,0x00000045,0x00000046,0x00000043,0x00000044,0x0000002A,0x00000001,0x00000001,0x0000002A,0x00000045,0x00000046,
0x00000043,0x00000044,0x0000002A,0x0000002A,0x0000002A,0x00000056,0x00000057,0x00000052,0x00000053,0x0000002A,0x00000001,0x00000001,0x0000002A,0x00000045,0x00000046,
0x00000043,0x00000044,0x0000002A,0x0000002A,0x0000002A,0x0000005A,0x0000005B,0x00000054,0x00000055,0x0000002A,0x00000001,0x00000001,0x0000002A,0x00000045,0x00000046,
0x00000043,0x00000044,0x0000002A,0x0000002A,0x0000002A,0x0000002A,0x0000002A,0x0000002A,0x0000002A,0x00000038,0x00000001,0x00000001,0x0000002A,0x00000045,0x00000046,
0x00000043,0x00000044,0x0000002A,0x0000002A,0x0000002A,0x0000002A,0x0000002A,0x00000038,0x00000001,0x00000001,0x00000001,0x00000001,0x0000002A,0x00000045,0x00000046,
