0x00000004,0x00000004,0x00000004,0x00000004,0x00000004,0x00000004,0x00000004,0x00000004,0x00000004,0x00000004,0x00000004,0x00000004,0x00000004,0x00000004,0x00000004,
0x00000002,0x00000002,0x00000002,0x00000002,0x00000002,0x00000002,0x00000002,0x00000002,0x00000002,0x00000002,0x00000002,0x00000002,0x00000002,0x00000002,0x00000002,
0x00000002,0x00000002,0x00000002,0x00000002,0x00000000,0x00000017,0x00000018,0x00000000,0x00000002,0x00000002,0x00000002,0x00000002,0x00000002,0x00000002,0x00000002,
0x00000002,0x00000002,0x00000002,0x00000002,0x00000000,0x00000019,0x0000001A,0x00000000,0x00000002,0x00000002,0x00000002,0x00000071,0x00000071,0x00000071,0x00000071,
0x00000072,0x00000073,0x00000002,0x00000002,0x00000000,0x00000000,0x00000000,0x00000000,0x00000002,0x00000002,0x00000002,0x00000002,0x00000002,0x00000002,0x00000002,
0x00000074,0x00000075,0x00000002,0x00000002,0x00000002,0x00000002,0x00000079,0x0000007A,0x00000071,0x00000071,0x00000071,0x00000071,0x00000071,0x00000071,0x00000002,
0x00000076,0x00000077,0x00000071,0x00000002,0x00000002,0x00000002,0x0000007B,0x0000007C,0x00000002,0x00000002,0x00000002,0x00000002,0x00000002,0x00000002,0x00000002,
0x00000002,0x00000002,0x00000002,0x00000071,0x00000071,0x00000071,0x0000007D,0x0000007E,0x00000002,0x00000002,0x00000002,0x00000002,0x00000001,0x00000006,0x00000007,
0x00000002,0x00000002,0x00000002,0x00000071,0x00000002,0x00000002,0x00000002,0x00000002,0x00000002,0x00000002,0x00000002,0x00000002,0x00000001,0x00000008,0x00000009,
0x00000002,0x00000002,0x00000002,0x00000002,0x00000002,0x00000002,0x00000002,0x00000002,0x00000002,0x00000002,0x00000002,0x00000002,0x00000001,0x00000001,0x00000001,
0x00000002,0x00000002,0x00000002,0x00000002,0x00000002,0x00000002,0x00000002,0x00000002,0x00000002,0x00000002,0x00000002,0x00000002,0x00000002,0x00000002,0x00000002,
0x00000002,0x00000002,0x00000002,0x00000002,0x00000002,0x00000071,0x00000071,0x00000071,0x00000071,0x00000078,0x00000078,0x00000078,0x00000071,0x00000071,0x00000071,
0x00000071,0x00000072,0x00000073,0x00000002,0x00000002,0x00000071,0x00000071,0x00000071,0x00000002,0x00000078,0x00000078,0x00000078,0x00000002,0x00000071,0x00000002,
0x00000002,0x00000074,0x00000075,0x00000002,0x00000002,0x00000002,0x00000002,0x00000002,0x00000002,0x00000002,0x00000002,0x00000002,0x00000002,0x00000002,0x00000002,
0x00000002,0x00000076,0x00000077,0x00000071,0x00000002,0x00000002,0x00000002,0x00000002,0x00000002,0x00000002,0x00000002,0x00000002,0x00000002,0x00000002,0x00000071,
0x00000004,0x00000004,0x00000004,0x00000004,0x00000004,0x00000004,0x00000004,0x00000004,0x00000004,0x00000004,0x00000004,0x00000004,0x00000004,0x00000004,0x00000004,
