0x00000063,0x00000060,0x00000061,0x00000062,0x00000063,0x00000060,0x00000061,0x00000062,0x00000063,0x00000060,0x00000000,0x00000004,0x00000004,0x00000004,0x00000004,
0x00000067,0x00000064,0x00000065,0x00000066,0x00000067,0x00000064,0x00000065,0x00000066,0x00000067,0x00000064,0x00000004,0x00000005,0x00000005,0x00000005,0x00000005,
0x0000002A,0x0000002A,0x0000002A,0x0000002A,0x0000002A,0x0000002A,0x0000002A,0x0000002A,0x0000002A,0x00000038,0x00000005,0x00000001,0x00000001,0x00000001,0x00000001,
0x0000002A,0x0000002A,0x0000002A,0x0000002A,0x0000002A,0x00000038,0x00000001,0x00000001,0x00000001,0x00000001,0x00000001,0x00000001,0x00000001,0x00000001,0x00000001,
0x0000002A,0x0000002A,0x0000002A,0x00000038,0x00000001,0x00000001,0x00000001,0x00000001,0x00000001,0x00000001,0x00000001,0x00000001,0x00000001,0x00000001,0x00000001,
0x00000000,0x00000017,0x00000018,0x00000000,0x00000002,0x00000002,0x00000002,0x00000002,0x00000002,0x00000001,0x00000001,0x00000001,0x00000001,0x00000001,0x00000001,
0x00000000,0x00000019,0x0000001A,0x00000000,0x00000002,0x00000001,0x00000001,0x00000001,0x00000002,0x00000001,0x00000001,0x00000001,0x00000001,0x00000001,0x00000001,
0x00000000,0x00000000,0x00000000,0x00000000,0x00000002,0x00000001,0x00000001,0x00000001,0x00000002,0x00000001,0x00000001,0x00000001,0x00000001,0x00000001,0x00000001,
0x00000002,0x00000002,0x00000002,0x00000002,0x00000002,0x00000002,0x00000002,0x00000002,0x00000002,0x00000002,0x00000002,0x00000002,0x00000002,0x00000002,0x00000002,
0x00000002,0x00000001,0x00000001,0x00000001,0x00000002,0x00000000,0x00000017,0x00000018,0x00000000,0x00000001,0x00000001,0x00000001,0x00000001,0x00000001,0x00000001,
0x00000002,0x00000001,0x00000001,0x00000001,0x00000002,0x00000000,0x00000019,0x0000001A,0x00000000,0x00000001,0x00000001,0x00000001,0x00000001,0x00000001,0x00000001,
0x00000002,0x00000002,0x00000002,0x00000002,0x00000002,0x00000000,0x00000000,0x00000000,0x00000000,0x00000001,0x00000001,0x00000001,0x00000001,0x00000001,0x00000001,
0x0000002A,0x0000002B,0x00000001,0x00000001,0x00000001,0x00000001,0x00000001,0x00000001,0x00000001,0x00000001,0x00000001,0x00000001,0x00000001,0x00000001,0x00000001,
0x0000002A,0x0000002A,0x0000002A,0x0000002A,0x0000002B,0x00000001,0x00000001,0x00000001,0x00000001,0x00000001,0x00000001,0x00000001,0x00000001,0x00000001,0x00000001,
0x0000002A,0x0000002A,0x0000002A,0x0000002A,0x0000002A,0x0000002A,0x0000002A,0x0000002A,0x0000002B,0x00000001,0x00000001,0x00000001,0x00000001,0x00000001,0x00000001,
0x00000063,0x00000060,0x00000061,0x00000062,0x00000063,0x00000060,0x00000061,0x00000062,0x00000063,0x00000060,0x00000004,0x00000004,0x00000004,0x00000004,0x00000004,
