0x0000006F,0x00000070,0x00000001,0x00000001,0x00000001,0x00000001,0x00000002,0x00000002,0x00000001,0x00000001,0x0000003A,0x0000003B,0x00000001,0x00000001,0x00000000,
0x0000006F,0x00000070,0x00000001,0x00000001,0x00000001,0x00000001,0x00000002,0x00000002,0x00000001,0x00000001,0x0000003C,0x0000003D,0x00000001,0x00000001,0x00000000,
0x0000006F,0x00000070,0x00000000,0x00000017,0x00000018,0x00000000,0x00000002,0x00000002,0x00000001,0x00000001,0x00000001,0x00000001,0x00000001,0x0000006A,0x0000006B,
0x0000006F,0x00000070,0x00000000,0x00000019,0x0000001A,0x00000000,0x00000002,0x00000002,0x00000001,0x00000001,0x00000001,0x00000001,0x00000001,0x00000068,0x00000069,
0x0000006F,0x00000070,0x00000000,0x00000000,0x00000000,0x00000000,0x00000002,0x00000002,0x00000001,0x00000001,0x00000001,0x00000001,0x00000001,0x00000068,0x00000069,
0x0000006F,0x00000070,0x00000001,0x00000001,0x00000001,0x00000001,0x00000002,0x00000002,0x00000000,0x00000017,0x00000018,0x00000000,0x00000001,0x00000068,0x00000069,
0x0000006F,0x00000070,0x00000001,0x00000001,0x00000001,0x00000001,0x00000002,0x00000002,0x00000000,0x00000019,0x0000001A,0x00000000,0x00000001,0x00000068,0x00000069,
0x0000006F,0x00000070,0x00000001,0x00000001,0x00000001,0x00000001,0x00000002,0x00000002,0x00000000,0x00000000,0x00000000,0x00000000,0x00000001,0x00000068,0x00000069,
0x0000006F,0x00000070,0x00000001,0x00000001,0x00000001,0x00000001,0x00000002,0x00000002,0x00000001,0x00000001,0x00000001,0x00000001,0x00000001,0x00000068,0x00000069,
0x0000006F,0x00000070,0x00000000,0x00000017,0x00000018,0x00000000,0x00000002,0x00000002,0x00000001,0x00000001,0x00000001,0x00000001,0x00000001,0x00000068,0x00000069,
0x0000006F,0x00000070,0x00000000,0x00000019,0x0000001A,0x00000000,0x00000002,0x00000002,0x00000001,0x00000001,0x00000001,0x00000001,0x00000001,0x00000068,0x00000069,
0x0000006F,0x00000070,0x00000000,0x00000000,0x00000000,0x00000000,0x00000002,0x00000002,0x00000001,0x00000001,0x00000001,0x00000001,0x00000001,0x00000068,0x00000069,
0x0000006F,0x00000070,0x00000001,0x00000001,0x00000001,0x00000001,0x00000002,0x00000002,0x00000001,0x00000001,0x00000001,0x00000001,0x00000001,0x00000068,0x00000069,
0x0000006F,0x00000070,0x00000001,0x00000001,0x00000001,0x00000001,0x00000002,0x00000002,0x00000001,0x00000001,0x00000001,0x00000001,0x00000001,0x00000068,0x00000069,
0x0000006F,0x00000070,0x00000001,0x00000001,0x00000001,0x00000001,0x00000002,0x00000002,0x00000000,0x00000017,0x00000018,0x00000000,0x00000001,0x00000068,0x00000069,
0x0000006F,0x00000070,0x00000001,0x00000001,0x00000001,0x00000001,0x00000002,0x00000002,0x00000000,0x00000019,0x0000001A,0x00000000,0x00000001,0x00000068,0x00000069,
