0x00000062,0x00000063,0x00000060,0x00000061,0x00000062,0x00000063,0x00000060,0x00000061,0x00000062,0x00000063,0x00000060,0x00000061,0x00000062,0x00000063,0x00000060,
0x00000066,0x00000067,0x00000064,0x00000065,0x00000066,0x00000067,0x00000064,0x00000065,0x00000066,0x00000067,0x00000064,0x00000065,0x00000066,0x00000067,0x00000064,
0x0000002A,0x0000002A,0x0000002A,0x0000002A,0x0000002A,0x0000002A,0x0000002A,0x0000002A,0x0000002A,0x0000002A,0x00000060,0x00000061,0x00000062,0x00000063,0x00000060,
0x00000001,0x00000001,0x0000003A,0x0000003B,0x00000039,0x0000002A,0x0000002A,0x0000002A,0x0000002A,0x0000002A,0x00000064,0x00000065,0x00000066,0x00000067,0x00000064,
0x0000003A,0x0000003B,0x0000003C,0x0000003D,0x00000001,0x00000039,0x0000002A,0x0000002A,0x0000002A,0x0000002A,0x0000002A,0x0000002A,0x0000002A,0x0000002A,0x00000060,
0x0000003C,0x0000003D,0x00000001,0x00000001,0x00000001,0x00000001,0x00000001,0x00000039,0x0000002A,0x0000002A,0x0000002A,0x0000002A,0x0000002A,0x0000002A,0x00000064,
0x00000001,0x00000001,0x00000001,0x00000001,0x00000001,0x00000001,0x00000001,0x00000001,0x00000001,0x00000001,0x00000001,0x00000039,0x0000002A,0x0000002A,0x0000002A,
0x00000001,0x00000001,0x00000001,0x00000001,0x00000001,0x00000001,0x00000001,0x00000001,0x00000001,0x00000001,0x00000001,0x00000001,0x00000001,0x00000039,0x0000002A,
0x00000001,0x00000001,0x00000002,0x00000002,0x00000002,0x00000002,0x00000002,0x00000002,0x00000002,0x00000002,0x00000002,0x00000002,0x00000001,0x00000001,0x00000039,
0x00000001,0x00000001,0x00000002,0x00000001,0x00000001,0x00000001,0x00000001,0x00000001,0x00000001,0x00000001,0x00000001,0x00000002,0x00000002,0x00000002,0x00000002,
0x00000001,0x00000001,0x00000002,0x00000001,0x00000001,0x00000001,0x00000001,0x00000001,0x00000001,0x00000001,0x00000029,0x0000002A,0x0000002A,0x0000002A,0x0000002A,
0x00000002,0x00000002,0x00000002,0x00000001,0x00000029,0x0000002A,0x0000002A,0x0000002A,0x0000002A,0x0000002A,0x0000002A,0x0000002A,0x0000002A,0x0000002A,0x0000002A,
0x00000001,0x00000001,0x00000001,0x00000029,0x0000002A,0x0000002A,0x0000002A,0x0000002A,0x0000002A,0x0000002A,0x0000002A,0x0000002A,0x0000002A,0x0000002A,0x0000002A,
0x0000002A,0x0000002A,0x0000002A,0x0000002A,0x0000002A,0x0000002A,0x0000002A,0x0000002A,0x0000002A,0x0000002A,0x0000002A,0x0000002A,0x0000002A,0x0000002A,0x00000060,
0x0000002A,0x0000002A,0x0000002A,0x0000002A,0x0000002A,0x0000002A,0x0000002A,0x0000002A,0x0000002A,0x0000002A,0x00000060,0x00000061,0x00000062,0x00000063,0x00000064,
0x00000062,0x00000063,0x00000060,0x00000061,0x00000062,0x00000063,0x00000060,0x00000061,0x00000062,0x00000063,0x00000064,0x00000065,0x00000066,0x00000067,0x00000060,
