0x00000033,0x00000033,0x00000033,0x00000033,0x00000033,0x00000035,0x00000035,0x00000033,0x00000033,0x00000035,0x00000035,0x00000035,0x00000035,0x00000033,0x00000033,
0x00000033,0x00000033,0x00000033,0x00000033,0x00000033,0x00000035,0x00000035,0x00000033,0x00000033,0x00000035,0x00000035,0x00000035,0x00000035,0x00000033,0x00000033,
0x00000033,0x00000033,0x00000033,0x00000033,0x00000033,0x00000035,0x00000035,0x00000033,0x00000033,0x00000035,0x00000035,0x00000035,0x00000035,0x00000033,0x00000033,
0x00000033,0x00000033,0x00000033,0x00000033,0x00000037,0x00000035,0x00000035,0x00000033,0x00000033,0x00000035,0x00000035,0x00000035,0x00000035,0x00000033,0x00000033,
0x00000033,0x00000033,0x00000033,0x00000033,0x00000033,0x00000035,0x00000035,0x00000033,0x00000033,0x00000035,0x00000035,0x00000035,0x00000035,0x00000034,0x00000036,
0x00000033,0x00000033,0x00000033,0x00000033,0x00000033,0x00000035,0x00000035,0x00000033,0x00000033,0x00000035,0x00000035,0x00000035,0x00000035,0x0000002C,0x0000002D,
0x00000033,0x00000037,0x00000033,0x00000033,0x00000033,0x00000035,0x00000035,0x00000033,0x00000033,0x00000035,0x00000035,0x00000035,0x00000035,0x0000002C,0x0000002D,
0x00000033,0x00000033,0x00000033,0x00000033,0x00000033,0x00000035,0x00000035,0x00000034,0x00000036,0x00000035,0x00000035,0x00000035,0x00000035,0x0000002C,0x0000002D,
0x00000033,0x00000033,0x00000033,0x00000033,0x00000033,0x00000035,0x00000035,0x0000002C,0x0000002C,0x0000002C,0x0000002C,0x0000002C,0x0000002C,0x0000002C,0x0000002D,
0x00000033,0x00000033,0x00000033,0x00000034,0x00000036,0x00000035,0x00000035,0x0000002C,0x0000002C,0x0000002C,0x0000002C,0x0000002C,0x0000002C,0x0000002C,0x0000002D,
0x00000033,0x00000034,0x00000036,0x0000002C,0x0000002C,0x0000002C,0x0000002C,0x0000002C,0x0000002C,0x0000002C,0x0000002C,0x0000002C,0x0000002C,0x0000002C,0x0000002D,
0x00000036,0x0000002C,0x0000002C,0x0000002C,0x0000002C,0x0000002C,0x0000002C,0x0000002C,0x0000002C,0x0000002C,0x0000002C,0x0000002C,0x0000002C,0x0000002C,0x0000002D,
0x0000002D,0x0000002C,0x0000002C,0x0000002C,0x0000002C,0x0000002C,0x0000002C,0x0000002C,0x0000002C,0x0000002C,0x0000002C,0x0000002C,0x0000002C,0x0000002C,0x0000002D,
0x0000002D,0x0000002C,0x0000002C,0x0000002C,0x0000002C,0x0000002C,0x0000002C,0x0000002C,0x0000002C,0x0000002C,0x0000002C,0x0000002C,0x0000002C,0x0000002C,0x0000002D,
0x0000002D,0x0000002C,0x0000002C,0x0000002C,0x0000002C,0x0000002C,0x00000038,0x00000002,0x00000002,0x00000001,0x00000039,0x0000002C,0x0000002C,0x0000002C,0x0000002D,
0x0000002D,0x0000002A,0x0000002A,0x00000038,0x00000001,0x00000001,0x00000001,0x00000002,0x00000002,0x00000001,0x00000001,0x00000001,0x00000039,0x0000002A,0x0000002D,
