0x00000033,0x00000033,0x00000033,0x00000035,0x00000035,0x00000035,0x0000004A,0x0000004A,0x0000004A,0x0000004A,0x0000004A,0x0000004A,0x0000004A,0x00000033,0x00000033,
0x00000033,0x00000033,0x00000033,0x0000004A,0x0000004A,0x0000004A,0x0000004A,0x0000004A,0x0000004A,0x0000004A,0x0000004A,0x0000004A,0x0000004A,0x00000033,0x00000033,
0x00000033,0x00000033,0x00000033,0x0000004A,0x0000004A,0x0000004A,0x0000004A,0x0000004A,0x0000004A,0x0000004A,0x0000004A,0x00000035,0x00000035,0x00000033,0x00000033,
0x00000033,0x00000033,0x00000033,0x00000037,0x00000033,0x00000033,0x00000037,0x00000033,0x00000037,0x00000033,0x00000033,0x00000035,0x00000035,0x00000033,0x00000033,
0x00000033,0x00000033,0x00000033,0x00000033,0x00000033,0x00000033,0x00000033,0x00000033,0x00000033,0x00000033,0x00000033,0x00000035,0x00000035,0x00000033,0x00000033,
0x00000033,0x00000033,0x00000033,0x00000033,0x00000033,0x00000033,0x00000033,0x00000033,0x00000033,0x00000033,0x00000033,0x00000035,0x00000035,0x00000033,0x00000033,
0x00000033,0x00000033,0x00000033,0x00000033,0x00000033,0x00000033,0x00000033,0x00000033,0x00000033,0x00000033,0x00000033,0x00000035,0x00000035,0x00000033,0x00000033,
0x00000033,0x00000033,0x00000033,0x00000033,0x00000033,0x00000033,0x00000033,0x00000033,0x00000033,0x00000033,0x00000033,0x00000035,0x00000035,0x00000033,0x00000033,
0x0000004A,0x0000004A,0x0000004A,0x0000004A,0x00000035,0x00000033,0x00000033,0x00000033,0x00000033,0x00000033,0x00000033,0x00000035,0x00000035,0x00000033,0x00000033,
0x0000004A,0x0000004A,0x0000004A,0x0000004A,0x00000035,0x00000033,0x00000033,0x00000033,0x00000033,0x00000033,0x00000033,0x00000035,0x00000035,0x00000033,0x00000033,
0x0000004A,0x0000004A,0x0000004A,0x0000004A,0x00000035,0x0000004A,0x0000004A,0x0000004A,0x0000004A,0x0000004A,0x0000004A,0x00000035,0x00000035,0x00000033,0x00000033,
0x00000037,0x00000033,0x00000033,0x00000035,0x00000035,0x0000004A,0x0000004A,0x0000004A,0x0000004A,0x0000004A,0x0000004A,0x0000004A,0x0000004A,0x00000033,0x00000033,
0x00000033,0x00000033,0x00000033,0x00000035,0x00000035,0x0000004A,0x0000004A,0x0000004A,0x0000004A,0x0000004A,0x0000004A,0x0000004A,0x0000004A,0x00000033,0x00000033,
0x00000033,0x00000033,0x00000033,0x00000037,0x00000033,0x00000033,0x00000037,0x00000037,0x00000033,0x00000037,0x00000033,0x00000037,0x00000033,0x00000033,0x00000033,
0x00000033,0x00000033,0x00000033,0x00000033,0x00000033,0x00000033,0x00000033,0x00000033,0x00000033,0x00000033,0x00000033,0x00000033,0x00000033,0x00000033,0x00000033,
0x00000033,0x00000033,0x00000033,0x00000033,0x00000033,0x00000033,0x00000033,0x00000033,0x00000033,0x00000033,0x00000033,0x00000033,0x00000033,0x00000033,0x00000033,
